11111111111
1000C100CP1
1E010000001
11111111111