11111111111111111111111111
1C000000000Y000C00000C0001
10100101001000001010010001
10100100101010100010010Y01
1P0000000C00C0000000000001
10000001100011C00000110001
1110100000011001100111C011
100Y0001100000000000000001
100000000000000E0000000001
111100000C0C00010000000001
1000000000CC00000000Y00001
11111111111111111111111111