111111111111111111111111111111
1P0111110011000100100100101111
110000000001110100100101101011
110111011011010110101101001011
110001010000010010111001101001
101111011111010010001110101111
101000000000011011100000100011
111001111111101000111110111001
100111000000001111000010001101
110101010111110001011110100101
110101110101000011000100110101
110100001101011110001100100111
100100111001110000111011100011
110101100000000011100000101111
110101011111110110110111101001
111101000100010000010001001001
101001110111011111010111011001
101110011001000001110010010011
111010001101101100001111111111
100010000100111001001000000011
111001110111001101111011110001
101001010001010110000110010111
101011011101010011011100010101
101110110001010001110110110101
100000101111010000000010100111
101011100010011110111010110001
111010110110010011101100011101
110010000101111100000111010101
111011011101000C011100010001E1
111111111111111111111111111111