111111111111111111111111111111
1C0010001000000000010001000001
101010100001111101000100011101
100010111111000000011101100001
101010100000E00011000001001001
101010001110010100011000001011
101010100100110100110001101001
101010100110000111000100010101
101110100000111100001111000101
100000101110100000100100000101
101111100001101111100000011101
100001001000100100000111000001
110101001110000111100000111101
1P01000010001000000010000000Y1
111111111111111111111111111111